1111111111
1000B0C001
1000000001
1000001001
100B011001
100E000001
1000000P01
1111111111
