1111111111
10000000C1
100000P001
1000000001
1000000001
10E0000001
1000000001
1111111111