1111111111
1000B00001
101C000C01
1000001001
100B011001
1000000001
10E00P00C1
1111111111
